12
"++++++++++++"
"+s  +     g+"
"+    g+    +"
"+  +  +    +"
"+ +     +  +"
"+  g +   g +"
"+ +    +   +"
"+  ++g     +"
"+     ++ + +"
"++  + +    +"
"+g   +    e+"
"++++++++++++"

