24
"XXXXXXXXXXXXXXXXXXXXXX"
"XP     XX           GX"
"X      XX            X"
"X         GXX        X"
"X          XX        X"
"X    XX    XX        X"
"X    XX    XX        X"
"X  XX          XX    X"
"X  XX          XX    X"
"X    G   XX      G   X"
"X        XX          X"
"X  XX        XX      X"
"X  XX        XX      X"
"X    XXXXGG          X"
"X    XXXX            X"
"X          XXXX  XX  X"
"X          XXXX  XX  X"
"XXX    XX  XXG       X"
"XXX    XX  XX        X"
"X        XX          X"
"XG       XX         TX"
"XXXXXXXXXXXXXXXXXXXXXX"